嘮叨 - 夠
守門員 - 閃
我的心 - 悟
十五天 - 胖
九十九 - 白
真丟人 - 直
獨眼龍 - 省
這一頁 - 題
東洋兵 - 暈
草上飛 - 早
你我他 - 仨
兄有債 - 歌
皇帝新衣 - 襲
禮義廉恥 - 羅
男生太多 - 妙
十加二十 - 卉
初秋女裝 - 委
十個哥哥 - 克
一箭穿心 - 必
一心向上 - 必
上下一體 - 卡
上下難分 - 卡
拿不出手 - 合
鏡中人影 - 入
向陽門第 - 間
言出必行 - 若
連夜造林 - 夢
林海無邊 - 梅
東洋皇帝 - 旺
犧牲小我 - 舒
是謂泰山 - 仗
欲言又止 - 認
喜上加喜 - 囍
不少一撇 - 下
伊麗莎白 - 瑛
地心引力 - 動
點點成金 - 全
帶魚味美 - 羊
半真半假 - 值
公而忘私 - 八
服裝展覽 - 裂
閨中少女 - 娃
毛遂自薦 - 衙
同胞兄弟 - 捉
岳父大人 - 仗
兩狗談天 - 獄
有點自大 - 臭
眾樹成林 - 森
半部春秋 - 秦
美味佳肴 - 呵
四川的角 - 觸
金木水火 - 坎
十字路口 - 較、古、田
三人傳聖火 - 焱
舌頭砍掉了 - 古
大人挑小人 - 夾
李時珍名著 - 苯
你我各一半 - 伐
缺一點良心 - 懇
一家十一口 - 吉
三星伴新月 - 心
入門無犬吠 - 問
七十二小時 - 晶
日落半林中 - 東
八兄弟同賞月 - 脫
正月沒有初一 - 肯
何需殺人滅口 - 丁
十六兩多一點 - 斥
早不說晚不說 - 許
每人栽樹五棵 - 梧
一邊彎一邊脹 - 張
聾啞人士對談 - 批
一胎喜得兩千金 - 瓶
一月一日非今天 - 明
米老鼠和唐老鴨 - 糖
一口咬掉牛尾巴 - 告
一口咬去多半截 - 名
一邊有水一邊幹 - 汗
一口咬掉牛尾巴 - 告
一心依賴實為惰 - 懶
千里姻緣一線牽 - 重
大河沒水小河干 - 哥
大火燒到耳朵邊 - 耿
中心一點口不見 - 卜
石頭撐起一座山 - 岩
田裏雨後長青草 - 蕾
行人弓箭各在腰 - 夷
竹林深處有僧家 - 等
有人無人都是你 - 爾
良辰美景畫中看 - 田
雨余山色渾如睡 - 雪
雨後天晴太陽隱 - 清
兩人力大衝破天 - 夫
空山之中一畝田 - 畫
風吹草低見牛羊 - 蓄
夜裏十一點前後 - 孩
東西南北無彎路 - 置
昨日之日不可留 - 乍
放眼唯有一孤帆 - 艦
風絲雨點滿地揚 - 飛
高風亮節留人間 - 偵
眼看田上長青草 - 瞄
蓬萊下八戒出世 - 蕤
一貫用心習以為常 - 慣
三人行，其中有我 - 衙
千里之行始於足下 - 踵
上山下廠參加勞動 - 岸
壯士一去兮不復返 - 版
無角牛登上沒峰山 - 擊
削去朽木加工就妙 - 巧
善始善終一心到底 - 總
三人騎牛，牛無角 - 奉
需要一半，留下一半 - 雷
有弟弟有姊姊有妹妹 - 歌
前前後後都要放在心上 - 總
一家有四口，還有一隻狗 - 器
一字生得巧，四面八隻腳 - 井
一人一張口，口下長只手 - 拿
土上有竹林，土下一寸金 - 等
四面都是山，山山接相連 - 田
世上有一字，半月才寫完 - 胖
是船不叫船，只因缺半邊 - 舟
上面正差一筆，下面少去一點 - 步
一隻狗，兩個口，誰遇它誰發愁 - 哭
存心不讓出大門，你說煩人不煩人 - 悶
一字六筆無豎橫，同心同德力無窮 - 眾
兔兒頭上戴頂帽，滿腹苦水無處申 - 冤
既有頭，又有尾，中間生了四張嘴 - 申
雖有十張口，只有一顆心；要想猜出來，必須動腦筋 - 思